PPPPPPPPPPPPPPPPPPPPPPPPPPPPPPPPPPPPPPPPPPPPPPPPPPPPPPPPPPPPPPPPPPPPPPPPPPPPPPPPPPPPPPPPPPPPPPPPPPPPPPPPPPPPPPPPPPPPPPPP
P0000000000000000000000000000000000000000000000000000000000000000000000000000000000000000000000000000000000000000000000P
P0000000000000000000000000000000000000000000000000000000000000000000000000000000000000000000000000000000000000000000000P
P000000000000000000000000000000000000000000000000000000T0000T0000000000000000000000000000000000000000000000000000000000P
P00000000000000000000000000000000000000000000000000000000000000000000000000000000000000T0000000000000000000000000000000P
P000000000000000000000000000000000000000000000000000PPPPPPPPPPL00000000000000000000000000000000000000000000000000000000P
P000000000000000000000000000000000000000000000000000PPPPPPPPPPL00000000000T00000000PPPPPPP00000T00000000000000000000000P
P00000000T0000000000T00000000000000000000000000000000000000000L00000000000000000000PPPPPPP00000000000000000000000000000P
P0000000000000000000000000000000000000000000000000000000000000L0000000LPPPPPPP00000PPPPPPP00LPPPPPP00000000000000000000P
P0000000PPPPL00000PPPPL00000000000000000000000000000000T0000T0L00PPPP0LPPPPPPP00000000000000LPPPPPP00000000000000000000P
P0000000PPPPL00000PPPPL0000000T00LPPPPP00000000000000000000000L00PPPP0L0000PPP00000000000000LPPPPPP00000000000000000000P
P00000000000L000000000L0000000000LPPPPP00000LPPPPP00PPPPPPPPPPL0000000L0000PPP00000000000000L000000000LPPPPPPPPPPPPPPPPP
P00000000000L000000000L00000PPPP0LPPPPP00000LPPPPP00PPPPPPPPPPL0000000L0000PPP00000000000000L0000000T0LPPPPPPPPPPPPPPPPP
P00000000000L000000000L00000PPPP0LPPPPP00000LPPPPP000000000000L0000000L0000PPP0000LPPPPPP000L000000000LPPPPPPPPPPPPPPPPP
P00000000LPPPP00000000LPPPP0PPPP0LPPPPP00000LPPPPP000000000000L0000000L0000PPP0000LPPPPPP000L000000PPPLPPPPPPPPPPPPPPPPP
P00000000LPPPP00000T00LPPPP0PPPP0LPPPPP000T0LPPPPP000000000000L0000000L0000PPP0000LPPPPPP000L000000PPPLPPPPPPPPPPPPPPPPP
P00000000L000000000000L00000PPPP0LPPPPP00000LPPPPP000000000000L0000000L0000PPP0000LPPPPPP000L000000000LPPPPPPPPPPPPPPPPP
PPPPPPPPPPPPPPPPPPPPPPPPPPPPPPPPPPPPPPPPPPPPPPPPPPPPPPPPPPPPPPPPPPPPPPPPPPPPPPPPPPPPPPPPPPPPPPPPPPPPPPPPPPPPPPPPPPPPPPPP