PPPPPPPPPPPPPPPPPPPPPPPPPPPPPPPPPPPPPPPPPPPPPPPPPPPPPPPPPPPPPPPPPPPPPPPPPPPPPPPPPPPPPPPPPPPPPPPPPPPPPPPPPPPPPPPPPPPPPPPP
P0000000000000000000000000000000000000000000000000000000000000000000000000000000000000000000000000000000000000000000000P
P0000000000000000000000000000000000000000000000000000000000000000000000000000000000000000000000000000000000000000000000P
P0000000000000000000000000000000000000000000000000000000000000000000000000000000000000000000000000000000000000000000000P
P0000000000000000000000T0000000000000000000T0000000000000000T00000T0000000000000000000000000000000000000000000000000000P
P0000000000000000000000000000000000000000000000000000000000000000000000000000000000000000000000000000000000000000000000P
P0000000LPPPPPPPP0000LPPPP0000000000000LPPPPPPP0000000000LPPPPPPPPPPP0000000000000000T000000000000000000000000000000000P
P0000000LPPPPPPPP0000LPPPP0000000000000LPPPPPPP0000000000LPPPPPPPPPPP00000000000000000000000000000000000000000000000000P
P0000000L000000000000L00000000000000000L00000000000000000L000000000000000000000000LPPPPPP000000000000000000000000000000P
P0000000L000000000000L00000000000T00000L00000000000000000L00000000000000LPPPPPP000LPPPPPP000000000000000000000000000000P
P0000000L00000000T000L00000000000000000L0000000000T000000L00000000000000LPPPPPP000LPPPPPP000000000000000000000000000000P
P0000000L000000000000L00000LPPPPPPPPPP0L00000000000000000L0000T000000000LPPPPPP000LPPPPPP00LPPPPP0000000000000000T00000P
P000000LPPPPPPPPPPPPPPP0000LPPPPPPPPPP0L0000000LPPPPPPP00L00000000000000LPPPPPP000L00000000LPPPPP0000000000000000000000P
P000000LPPPPPPPPPPPPPPP0000LPPPPPPPPPP0LLPPPP00LPPPPPPP00PPPPPPPPPPPP000LPPPP00000L00000000L000000PPPPPPPPPPPPPPPPPPPPPP
P000000L0000000000000000000LPPPPPPPPPP0LLPPPP00LPPPPPPP00PPPPPPPPPPPP000LPPPP00000L00000000L000000PPPPPPPPPPPPPPPPPPPPPP
P000000L00000000000000000T0LPPPPPPPPPP0LLPPPP0TLPPPPPPP00000000000000000LPPPP00000L00000000L000000PPPPPPPPPPPPPPPPPPPPPP
P000000L0000000000000000000LPPPPPPPPPP0LLPPPP00LPPPPPPP00000000000000000LPPPP00000L00000000L000000PPPPPPPPPPPPPPPPPPPPPP
PPPPPPPPPPPPPPPPPPPPPPPPPPPPPPPPPPPPPPPPPPPPPPPPPPPPPPPPPPPPPPPPPPPPPPPPPPPPPPPPPPPPPPPPPPPPPPPPPPPPPPPPPPPPPPPPPPPPPPPP