PPPPPPPPPPPPPPPPPPPPPPPPPPPPPPPPPPPPPPPPPPPPPPPPPPPPPPPPPPPPPPPPPPPPPPPPPPPPPPPPPPPPPPPPPPPPPPPPPPPPPPPPPPPPPPPPPPPPPPPP
P0000000000000000000000000000000000000000000000000000000000000000000000000000000000000000000000000000000000000000000000P
P0000000000000000000000000000000000000000000000000000000000000000000000000000000000000000000000000000000000000000000000P
P0000000000000000000000000000000000000000000000000000000000000000000000000000000000000000000000000000000000000000000000P
P0000000000000000000000000000000000000000000000000000000000000000000000000000000000000000000000000000000000000000000000P
P0000000000000000000000000000000000000000000000000000000000000000000000000000000000000000000000000000000000000000000000P
P0000000000000000000000000000000000T00000000000000000000000000000000000T00000PPPPPP000000000000000000000000000000000000P
P0000000000000000000000000000000000000000000000000000000000000000000000000000PPPPPP000PP0000000000000000000000000000000P
P000000000000LPP000PP000PP000PP000PPPL0PP0T00000PP0000000000T000000PPPPPPPPL0000000000PP0000000000000000000000000000000P
P000000000000LPP000PP000PP000PP000PPPL0PP0000000PP00000000000000000PPPPPPPPL0000000000000000000T0000000000LPP0000000000P
P000000000000L00000000000000000000000L0PPPPP0000000000PPPPPPPPPPL0000000000L000000000000000000000000000000LPP0000000000P
P000000000T00L0000T000000000T00000000L0000000000000000PPPPPPPPPPL0000000000L00000000PP0000T00LPPP000000LPPL000PP0T00000P
P000000000000L00000000000000000000000L00000000000000000000000000L000T000000L000LPPP0PP0000000LPPP000000LPP0000PP0000000P
P00000000LPP0LPPPPPP000000LPPPPPL0000L00000LPPPPL0PP000000000000L0000000000L0PPLPPP0PP00PPPPPLPPP000000LPP000LPPPPPPPPPP
P00000000LPP0LPPPPPP000000LPPPPPLPPPPP00000LPPPPL0PP0000LPP00LPPL00PPPPPPPPL0PPL0000PP00PPPPPLPPP000000LPP000LPPPPPPPPPP
P00000000LPP0L000000000PP0LPPPPPLPPPPP00PPPLPPPPL00000T0LPP00LPPL00PPPPPPPPL000L0000PP0000000LPPP000LPPLPP000LPPPPPPPPPP
P00000000LPP0L000000000PP0LPPPPPL0000000PPPLPPPPL0000000LPP00LPPL0000000000L000L0000PP0000000LPPP000LPPL00000LPPPPPPPPPP
PPPPPPPPPPPPPPPPPPPPPPPPPPPPPPPPPPPPPPPPPPPPPPPPPPPPPPPPPPPPPPPPPPPPPPPPPPPPPPPPPPPPPPPPPPPPPPPPPPPPPPPPPPPPPPPPPPPPPPPP