PPPPPPPPPPPPPPPPPPPPPPPP
000000000000000000000000
0000000000000000T0000000
000000000000000000000000
00000000000000PPPPL00000
00000000000000PPPPL00000
00T000000T0000PP00L00000
00000000000000PP00L00000
00PPP00LPPP0000000L00T00
00PPP00LPPP0000000L00000
0000000L0000000000LPPPPP
0000000L0000000000LPPPPP
0000000L0000000000LPPPPP
0000000L00T0PPL000LPPPPP
0000000L0000PPL000LPPPPP
00PPP00L0PPPPPL000LPPPPP
00PPP00L0PPPPPL000LPPPPP
PPPPPPPPPPPPPPPPPPPPPPPP