PPPPPPPPPPPPPPPPPPPPPPPP
000000000000000000000000
000000000000000000000000
000000000000000000000000
000000000000000000000000
000000000T000LPPP0000000
0000000000000LPPP0000000
000T000LPPP00L0000000T00
0000000LPPP00L0000000000
00PPP00L00000L0T000LPPP0
00PPP00L00000L00000LPPP0
0000000L0T000LPPP00LPPP0
0000000L00000LPPP00LPPP0
0000000LPPP00LPPP00LPPP0
0000000LPPP00LPPP00LPPP0
00PPP00LPPP00LPPP00LPPP0
00PPP00LPPP00LPPP00LPPP0
PPPPPPPPPPPPPPPPPPPPPPPP