PPPPPPPPPPPPPPPPPPPPPPPP
000000000000000000000000
000000000000000T00000000
000000000000000000000000
000000000PP000PPPPL00000
000000000PP000PPPPL00000
000000000000000000L00000
00PPPP000000T00000L0T000
00PPPP000000000000L00000
0000000000LPPPPPP0LPPP00
0000000000LPPPPPP0LPPP00
0000000000L0000000L00000
000000PP00L0T00000L00000
000000PP00L0000000L00000
0LPPL00000LPPP0000L00000
0LPPL00000LPPP0000L0T000
0LPPL00000LPPP0000L00000
PPPPPPPPPPPPPPPPPPPPPPPP