PPPPPPPPPPPPPPPPPPPPPPPP
000000000000000000000000
000000000000000000000000
000000000000000000000000
0000000000000000T0000000
000000000000000000000000
00000000LPPPPPPPPPPL0PP0
00000000LPPPPPPPPPPL0PP0
00000000L0000000000L0000
000T0000L0000000000L0T00
00000000L0T00000000L0000
0LPPP000L0000000000LPPP0
0LPPP000LPPPP000000LPPP0
0L000PP0LPPPP00PP00LPPP0
0L000PP0L000000PP00LPPP0
0L000PP0L00T0PPPP00LPPP0
0L000PP0L0000PPPP00LPPP0
PPPPPPPPPPPPPPPPPPPPPPPP