PPPPPPPPPPPPPPPPPPPPPPPP
000000000000000000000000
0T0000000000000000000000
000000000000000000000000
00PL00000000000000000000
00PL00000000000000000000
000L00000000000000T00000
000LPP000000000000000000
000LPP00000000000PPPL000
000LPPPPPP0000000PPPL000
000LPPPPPP00000T0000L0T0
000L0000000000000000L000
000L000000000LPPP000LPPP
000L000000000LPPP000LPPP
000L000000000LPPP000LPPP
000L000T00PP0L000000LPPP
000L000000PP0L000000LPPP
PPPPPPPPPPPPPPPPPPPPPPPP