PPPPPPPPPPPPPPPPPPPPPPPP
000000000000000000000000
000000000000000000000000
000000000000000000000000
00000T000000000000000000
000000000000000000000000
00PPPPPPL000000000000000
00PPPPPPL0000T00000000T0
00000000L000000000000000
00000000L000PPPL0000LPPP
00000000L000PPPL0000LPPP
0000000LPPP0000L00T0L000
0000000LPPP0000L0000L000
000LPPPL0000000L0PPPL000
000LPPPL00000PPL0PPPL000
000LPPPL0T000PPL0PPPL000
000LPPPL00000PPL0PPPL000
PPPPPPPPPPPPPPPPPPPPPPPP