PPPPPPPPPPPPPPPPPPPPPPPP
000000000000000000000000
0T0000000000000000000000
000000000000000000000000
00P0000T0000000000000000
00P000000000000000000LPP
0000LPPPPPP00000000T0LPP
0000LPPPPPP0000000000L00
0000LPP000000000LPPPPL00
0000LPP000000000LPPPPL00
0000LPP00000T000LPPPPL00
0000L00000000000LPPPPL00
0000L000000PPP00LPPPPL00
0000L0000T0PPP00LPPPPL00
0000L000000PPP00LPPPPL00
0000L00PPPPPPP00LPPPPL00
0000L00PPPPPPP00LPPPPL00
PPPPPPPPPPPPPPPPPPPPPPPP