PPPPPPPPPPPPPPPPPPPPPPPP
000000000000000000000000
000000000000000000000000
000000T00000000000000000
00000000000000T000000000
000LPPPPP000000000000000
000LPPPPP000PPPPL0000000
000L00000000PPPPL0000000
000L000000000000L0000000
000L000000000000L0T00000
00PL000000000000L0000000
00PL0000T00000LPPPPP0000
000L0000000000LPPPPP0000
000L000PPPPL00LPP0000000
000L000PPPPL00LPP0000LPP
000L00000T0L00LPP0000LPP
000L0000000L00LPP0000LPP
PPPPPPPPPPPPPPPPPPPPPPPP