PPPPPPPPPPPPPPPPPPPPPPPP
000000000000000000000000
000000000000000000000000
00T000000000000000000000
0000000000000T0000000000
00PPL0000000000000000000
00PPL000LPPPPPPPPPPPPPPP
0000L000LPPPPPPPPPPPPPPP
0000L000L000000000000000
0000L000L000000000000000
0000L000L0000000000000T0
0000L000L000000000000000
00PPL00LPPPPPPPPPPPPPPPP
00PPL00LPPPPPPPPPPPPPPPP
0000L00L0000000000000000
0T00L00L000000000T000000
0000L00L0000000000000000
PPPPPPPPPPPPPPPPPPPPPPPP