PPPPPPPPPPPPPPPPPPPPPPPP
000000000000000000000000
00T000000000000000000000
000000000000000000000000
00PPL000000T000000000000
00PPL00000000000PPL00000
0000L0000PPPP000PPL00000
0000L0000PPPP00000L000T0
0000L0000000000000L00000
0000L0000000000000L0LPPP
0000L000T0000000T0L0LPPP
0000L0000000000000L0LPPP
000LPPPPPPP0000PPPP0LPPP
000LPPPPPPP0000PPPP0LPPP
000LPP000000000PPPP0LPPP
000LPP000000000PPPP0LPPP
000LPP000000000PPPP0LPPP
PPPPPPPPPPPPPPPPPPPPPPPP